     ############## 
 ##### $     .....##
 #       ####..... #
 # #######  #..... #
 # #    $ $ ##....##
 # # $$ # # ###...# 
 # # $@$ $  ##### # 
## #  $  $ $$   $ # 
#  #$# $##  # $## # 
# ##    ## ## $ # # 
# # $# $ $  #     # 
# #         ####### 
# ########$##   #   
#        #  $   #   
########    #####   
       ###  #       
         ####       
